111111111111111111111
10C00C10C000000000001
1000001111000000C0001
101000110000CCC000P11
111000000000000000001
10000111000000E000CC1
111111111111111111111
