111111111111111111111
10C00C10C000000000001
100000111101111100001
101000110001CCC100P11
111000000001111100001
101000000000000000CC1
1000000C00000CC1E0001
111111111111111111111
