111111111111111111111
10C00C10C000000000001
1000001111000000C0001
101000110000CCC000P11
111000000000000000001
101000000000000000CC1
1000000C00000CC1E0001
111111111111111111100
